type octile
height 49
width 49
map
TTTTTTTTTTTTTTTTTTTTTTTTTTTTTTTTTTTTTTTTTTTTTTTTT
TTTTTTTTTT...........P.....................TTTTTT
TTTTTTTTT...TTTTTTTTT..TTTTTTTTTTTTTTTTTT...TTTTT
TT..........TTT........TTTTTTTTTTTTTTTTTT...TTTTT
TT..TTTTT...TTT.TTTTT................TTTT..TTTTTT
TT..TTTTT..TTTT.TTTTT..TTTTTTT.......TTTT..TTTTTT
TT..TTTTTTTTTTT...TTT..TTTTTTT.............TTTTTT
TT..TTT.........T..TTTTTTTTTTTTTTTT..TTTT.TTTTTTT
TT..TTT.TTT.....TT.....TTTTTTTTTTTT..TTTT.TTTTTTT
TT..TTT.TTT.TTTTTT........TTTTTTTTT..TTTT...TTTTT
TT..TTT.TTT.TTTTTTTT......TTTTTTTTT..TTTTTTTTTTTT
TTT......TT.TTTTTTTT......TTTTTTTTT..TTTTTTTTTTTT
TTTT.....TT.TTTTT......TTTTTTTTTTTT...TTTTTTTTTTT
TTTT.....TTTTTTTT.TTTTTTTTTTTTTTT..TT..TTTTTTTTTT
TTTT.....TTTTTTTT.TTTTTTTTTTTTTT..TTTT...TTTTTTTT
TTTTTT..TTTTTTTTT.TTTTTTTT...TTT..TTTTT..TTTTTTTT
TTTTTT..TTTTTTTTT.TT..............TTTTT..TTTTTTTT
TTTTTT..TTTTTTTT..TT...TTTT.TTTTTTTTTTT..TTTTTTTT
TTTTTT..TTTTTTTT.TTT...TTTT.TTTTTTTTTTT..TTTTTTTT
TTTTTT..TTTTTTTT.TTT...TTTT.TTTTTTTT.....TTTTTTTT
TTTTTT......TTT..TTT...TTTT.TTTTTTTT...TTTTTTTTTT
TTTTTTTTTTT.TTT.TTTT..TTTTT.TTTTTTTT...TTTTTTTTTT
TTTTTTTTTTT.TTT.TTTTTTTTTTT.TTTTTTTT...TTTTTTTTTT
TTTTTT......TTT.TTTTTTTTTTT.TTTTTTTTT.TTTTTTTTTTT
TTTTTT.TTTT.TTT.TTTTTTTTTTT.TTTTTTTTT.TTTTTTTTTTT
TTTTTT.TTTT.....TTTTTTTTTTT.TTTTTTTTT.TTTTTTTTTTT
TTTTTT.TTTT.TTTTTTTT........TTTTTTTTT.TTTTTTTTTTT
TTTTTTTTTT..TTTTTTTT..TTTT..TTTTTTTTT.TTTTTTTTTTT
TTTTTTTTTT..TTTTTTTT..TTTT..TTTTTTTTT.........TTT
TTTTTTTTTT..TTTTTTTT..TTT...TTTTTTTTT.........TTT
TTTTTTT.....TTTTTTTT..TTT...TTTTTTTTT.........TTT
TTTTTTT.....TTTTTTTT..TTT...TTTTTTTTTTTTT.TTTTTTT
TTT.........TTTTTTTT..TTTTT.........TTTTT.TTTTTTT
TTT.TTT.....TTTTTTTT..TTTTTTTTTTTTT.TTTTT.TTTTTTT
TTT.TTT.....TTTTTTTT..TTTTTTTTTTTT........TTTTTTT
TTT.TTTT....TTTTTTTT..TTTTTTTTTTTTTTTTT..TTTTTTTT
TTT.TTTTTT..TTTTTTTTTTTTTTTT.......TTTT..TTTTTTTT
TTT...TTTTT.TTTTTTTTTTT......TTTTT.TTTT..TTTTTTTT
TTT.TTTTTTT.............TTTTTTTTTT.TTTT..TTTTTTTT
TTT.TTTTTTT.TTTT..TTTTTTTTTTTTTTT..TTTT..TTTTTTTT
TTT.TTTTTTT.TTTT.......TTTTTTTTTT...TTT..TTTTTTTT
TTTTTTTTTTT.TTTT.......TTTTTTTT....TTTT......TTTT
TTTTTTTTTTT.TTTTTTTT...TTTTTTTT..TTTTTTTTTT..TTTT
TTTTTTTTTTT.TTTTTTTT...TTTTTTTT..TTTTTTTTTT..TTTT
TTTTTTTTTTT.TTTTTTTT....................TTTT..TTT
TTTTTTT.....TTTTTTTT...TTTTTTTTTTTTTTT..TTT..TTTT
TTTTTTTTTTT.TTTTTTTT...TTTTTTTT..........TT..TTTT
TTTTTTTTTTT.TTTTTTTT...TTTTT.....TTTTTTT.......TT
TTTTTTTTTTT..................TTTTTTTTT......STTTT
TTTTTTTTTTTTTTTTTTTTTTTTTTTTTTTTTTTTTTTTTTTTTTTTT