type octile
height 50
width 49
map
TTTTTTTTTTTTTTTTTTTTTTTTTTTTTTTTTTTTTTTTTTTTTTTTT
TTTTTTTTTT...........P.....................TTTTTT
TTTTTTTTT...................................TTTTT
TT..........TTT........TTTTTTTTTTTTTTTTTT...TTTTT
TT...TTTT...TTT.TTTTT................TTTT..TTTTTT
TT...TTTT..TTTT.TTTTT....TTTTT.......TTTT..TTTTTT
TT...TTTTTTTTTT....TT....TTTTT.............TTTTTT
TT...TT............TTTTTTTTTTTTTTTT..TTTT.TTTTTTT
TT...TT...T.....TT.....TTTTTTTTTTTT..TTTT.TTTTTTT
TT...TT..TT...TTTT........TTTTTTTTT..TTTT...TTTTT
TT...TT..TT...TTTTTT......TTTTTTTTT..TTTTTTTTTTTT
TTT......TT...TTTTTT......TTTTTTTTT..TTTTTTTTTTTT
TTTT.....TT....TT......TTTTTTTTTT.....TTTTTTTTTTT
TTTT.....TTT..TT....TTTTTTTTTTTT...TT...TTTTTTTTT
TTTT.....TTT..TT...TTTTTTTTTTTT...TTTT...TTTTTTTT
TTTTTT..TTTTTTTT...TTTTTTT...TT...TTTT...TTTTTTTT
TTTTTT..TTTTTTTT...T..............TTTT...TTTTTTTT
TTTTTT..TTTTTTTT...T...TTT...TTTTTTTTT...TTTTTTTT
TTTTTT..TTTTTTTT..TT...TTT...TTTTTTTTT...TTTTTTTT
TTTTTT......TTTT..TT...TTT...TTTTTTT.....TTTTTTTT
TTTTTT......TTT..TTT...TTT...TTTTTTT....TTTTTTTTT
TTTTTTTTT...TTT..TTT..TTTT...TTTTTTT....TTTTTTTTT
TTTTTTTTT...TTT..TTTTTTTTT...TTTTTTT....TTTTTTTTT
TTTT........TTT..TTTTTTTTT...TTTTTTTT...TTTTTTTTT
TTT....TT...TTT..TTTTTTTTT...TTTTTTTT...TTTTTTTTT
TTT....TT........TTTTTTTTT...TTTTTTTT...TTTTTTTTT
TTTTT..TT......TTTTT.........TTTTTTTT...TTTTTTTTT
TTTTTTTTTT.....TTTTT...TTT...TTTTTTTT...TTTTTTTTT
TTTTTTTTTT.....TTTTT...TTT...TTTTTTTT.........TTT
TTTTTTTTTT.....TTTTT...TT....TTTTTTTT.........TTT
TTTTTTT.......TTTTTT...TT....TTTTTTTT.........TTT
TTTTTTT......TTTTTTT...TT....TTTTTTTTTTT...TTTTTT
TTT.........TTTTTTTT.....TT.........TTTTT...TTTTT
TTT..TT.....TTTTTTTT...TTTTTTTTTTTT.TTTT...TTTTTT
TTT..TT.....TTTTTTTT...TTTTTTTTTTT........TTTTTTT
TTT..TTT....TTTTTTTT..TTTTTTTTTTTTTTTTT...TTTTTTT
TTT..TTTTT..TTTTTTTTTTTTTTTT.......TTTT...TTTTTTT
TTT...TTTT..TTTTTTTTTTT......TTTTT.TTTT...TTTTTTT
TTT....TTT..............TTTTTTTTTT.TTTT...TTTTTTT
TTT...TTTT..TTTT..TTTTTTTTTTTTTTT..TTTT...TTTTTTT
TTT...TTTT..TTTT.......TTTTTTTTTT...TTT...TTTTTTT
TTTTTTTTTT..TTTT.......TTTTTTTT....TTTT......TTTT
TTTTTTTTTT..TTTTTTTT...TTTTTTTT..TTTTTTTTT...TTTT
TTTTTTTTTT..TTTTTTTT...TTTTTTTT..TTTTTTTTT...TTTT
TTTTTTTT....TTTTTTTT....................TT....TTT
TTTTTTT.....TTTTTTTT...TTTTTTTTTTTTTTT..TTT..TTTT
TTTTTTTTTT...TTTTTTT...TTTTTTTT..........TT..TTTT
TTTTTTTTTT.......................TTT...........TT
TTTTTTTTTT...................TTTTTTTTT......STTTT
TTTTTTTTTTTTTTTTTTTTTTTTTTTTTTTTTTTTTTTTTTTTTTTTT
TTTTTTTTTTTTTTTTTTTTTTTTTTTTTTTTTTTTTTTTTTTTTTTTT