type octile
height 49
width 49
map
TTTTTTTTTTTTTTTTTTTTTTTTTTTTTTTTTTTTTTTTTTTTTTTTT
TTTTTTTTTTTTTTTTTTT..P..TTTTTTTTTTTTTTTTTTTTTTTTT
TTTTTTTTTTTTTTTTTTT.....TTTTTTTTTTTTTTTTTTTTTTTTT
TTTTTTTTTTTTTTTTTTT.....TTTTTTTTTTTTTTTTTTTTTTTTT
TTTTTTTTTTTTTTTTTTT.....TTTTTTTTTTTTTTTTTTTTTTTTT
TTTTTTTTTTTTTTTTTTT.....TTTTTTTTTTTTTTTTTTTTTTTTT
TTTTTTTTTTTTTTTTTTT.....TTTTTTTTTTTTTTTTTTTTTTTTT
TTTTTTTTTTTTTTTTTTT.....TTTTTTTTTTTTTTTTTTTTTTTTT
TTTTTTTTTTTTTTTTTTT.....TTTTTTTTTTTTTTTTTTTTTTTTT
TTTTTTTTTTTTTTTTTTT.....TTTTTTTTTTTTTTTTTTTTTTTTT
TTTTTTTTTTTTTTTTTTT.....TTTTTTTTTTTTTTTTTTTTTTTTT
TTTTTTTTTTTTTTTTTTT.....TTTTTTTTTTTTTTTTTTTTTTTTT
TTTTTTTTTTTTTTTTTTT.....TTTTTTTTTTTTTTTTTTTTTTTTT
TTTTTTTTTTTTTTTTTTT.....TTTTTTTTTTTTTTTTTTTTTTTTT
TTTTTTTTTTTTTTTTTTT.....TTTTTTTTTTTTTTTTTTTTTTTTT
TTTTTTTTTTTTTTTTTTT.....TTTTTTTTTTTTTTTTTTTTTTTTT
TTTTTTTTTTTTTTTTTTT.....TTTTTTTTTTTTTTTTTTTTTTTTT
TTTTTTTTTTTTTTTTTTT.....TTTTTTTTTTTTTTTTTTTTTTTTT
TTTTTTTTTTTTTTTTTTT.....TTTTTTTTTTTTTTTTTTTTTTTTT
TTTTTTTTTTTTTTTTTTT.....TTTTTTTTTTTTTTTTTTTTTTTTT
TTTTTTTTTTTTTTTTTTT.....TTTTTTTTTTTTTTTTTTTTTTTTT
TTTTTTTTTTTTTTTTTTT.....TTTTTTTTTTTTTTTTTTTTTTTTT
TTTTTTTTTTTTTTTTTTT.....TTTTTTTTTTTTTTTTTTTTTTTTT
TTTTTTTTTTTTTTTTTTT.....TTTTTTTTTTTTTTTTTTTTTTTTT
TTTTTTTTTTTTTTTTTTT.....TTTTTTTTTTTTTTTTTTTTTTTTT
TTTTTTTTTTTTTTTTTTT.....TTTTTTTTTTTTTTTTTTTTTTTTT
TTTTTTTTTTTTTTTTTTT.....TTTTTTTTTTTTTTTTTTTTTTTTT
TTTTTTTTTTTTTTTTTTT.....TTTTTTTTTTTTTTTTTTTTTTTTT
TTTTTTTTTTTTTTTTTTT.....TTTTTTTTTTTTTTTTTTTTTTTTT
TTTTTTTTTTTTTTTTTTT.....TTTTTTTTTTTTTTTTTTTTTTTTT
TTTTTTTTTTTTTTTTTTT.....TTTTTTTTTTTTTTTTTTTTTTTTT
TTTTTTTTTTTTTTTTTTT.....TTTTTTTTTTTTTTTTTTTTTTTTT
TTTTTTTTTTTTTTTTTTT.....TTTTTTTTTTTTTTTTTTTTTTTTT
TTTTTTTTTTTTTTTTTTT.....TTTTTTTTTTTTTTTTTTTTTTTTT
TTTTTTTTTTTTTTTTTTT.....TTTTTTTTTTTTTTTTTTTTTTTTT
TTTTTTTTTTTTTTTTTTT.....TTTTTTTTTTTTTTTTTTTTTTTTT
TTTTTTTTTTTTTTTTTTT.....TTTTTTTTTTTTTTTTTTTTTTTTT
TTTTTTTTTTTTTTTTTTT.....TTTTTTTTTTTTTTTTTTTTTTTTT
TTTTTTTTTTTTTTTTTTT.....TTTTTTTTTTTTTTTTTTTTTTTTT
TTTTTTTTTTTTTTTTTTT.....TTTTTTTTTTTTTTTTTTTTTTTTT
TTTTTTTTTTTTTTTTTTT.....TTTTTTTTTTTTTTTTTTTTTTTTT
TTTTTTTTTTTTTTTTTTT.....TTTTTTTTTTTTTTTTTTTTTTTTT
TTTTTTTTTTTTTTTTTTT.....TTTTTTTTTTTTTTTTTTTTTTTTT
TTTTTTTTTTTTTTTTTTT.....TTTTTTTTTTTTTTTTTTTTTTTTT
TTTTTTTTTTTTTTTTTTT.....TTTTTTTTTTTTTTTTTTTTTTTTT
TTTTTTTTTTTTTTTTTTT.....TTTTTTTTTTTTTTTTTTTTTTTTT
TTTTTTTTTTTTTTTTTTT.....TTTTTTTTTTTTTTTTTTTTTTTTT
TTTTTTTTTTTTTTTTTTT.....TTTTTTTTTTTTTTTTTTTTTTTTT
TTTTTTTTTTTTTTTTTTTT.S.TTTTTTTTTTTTTTTTTTTTTTTTTT
TTTTTTTTTTTTTTTTTTTTTTTTTTTTTTTTTTTTTTTTTTTTTTTTT